[level]
map = 111111111111111111111111111
	10001##0###0001#000#100#001
	10##1001000011#001###010#01
	110000100#1###1#1#111#10101
	1##1#00001000010##001##1#11
	1#0##1##111100###1000##00#1
	10#0#0###0111#1#1000#001#11
	1####01#0001##0##10#1#001#1
	11##0#11110000##1000#0010#1
	1#1###000#1####0##0#10#0#01
	1#1001#1##1#01#010###00#1#1
	1#01##0#0#0##0100010#####01
	1#00#1##0#00#11000##01000#1
	1##1###010##1##0##10###1##1
	100##10##011000##0#######01
	10#1000011#0##0###1##0#1101
	1####00#1##00#110#1#1000#01
	11#1#0##10#1#0111##1#01###1
	111####111#10#10###1#001101
	100##1###010###00#01110#101
	1000#11##10#111#0100010#001
	111111111111111111111111111
	

