[level]
map = 111111111111111111111111111
	100000##00##01####0##00##01
	101#101#1#1#1010101#101#101
	1###0##0##0#0###0#0#0###0#1
	10#111111111001#1#1#1#101#1
	1#11000000011###0##0#####01
	1#01111111110#01111111110#1
	1##00###0#####11000000011#1
	1#1#1#10101#10#111111111##1
	100###0###000#0###0###0###1
	1#1#101#1#101#1#101#1010101
	1##00###00##0##00#0#0####01
	1#1111101#1#1110101#11#1##1
	1#1###1#00##000#0#0#1##11#1
	1011#11#1010111#1#1#1101101
	1#110#10##00#0##0#001###1#1
	1##1#1101#101#10101#11111#1
	1#00#0##0####0#0#0##0##0#01
	1#110###1#11#1#111#1#111##1
	101##11#10#101#1#1#111#1101
	100##00#####0#1####0####001
	111111111111111111111111111